XXXXXXXXXXX
X     | XXX
X     X X-X
XXXX X X XX
X     X X X
X XXXX    X
X     XXXXX
XXX     XXX
X   X  XXXX
XXXXXXXXXXX