XXXXXXXXXXX
X     | XSX
X S   X X-X
XXXX X X XX
X     X X X
X XXXX    X
X     XXXXX
XXX     XXX
XE  X  XXXX
XXXXXXXXXXX