XXXXXXXXXXX
X     | XSX
X     X X-X
XXXX X X XX
X     X X X
X XXXX     
X     XXXXX
XXX     XXX
XE  X  XXXX
XXXXXXXXXXX